.........................#####...................................................................................................................#####..........................................................................................
.......................................................................................................................#........................................................................................................................
.................................................................................................................#.....#........................................................................................................................
.......................................................................................................................#........................................................................................................................
................................#######..............................................................................#.#........................................................................................................................
...............................#.......................................................................................#........................................................................................................................
..............................#.#...................................................................................#..#........................................................................................................................
.............................#...#.................................................................................#...#........................................................................................................................
............................#...###....#.....#....................................................................#....#........................................................................................................................
...........................#....................................................................................#......#........................................................................................................................
.........................##.............#####.................................................................#........#........................................................................................................................
.........................#...................................................................###...#...#.....#.......#.#........................................................................................................................
###################.##.######...#####.################################..############..#####################################################.##.######.#################.######################.#############..##################################
.....................................###########.......................................................................#........................................................................................................................
.......................................................................................................................#........................................................................................................................
.......................................................................................................................#........................................................................................................................
.......................................................................................................................#........................................................................................................................
.......................................................................................................................#........................................................................................................................
.......................................................................................................................#........................................................................................................................
.......................................................................................................................#........................................................................................................................
.......................................................................................................................#........................................................................................................................
.......................................................................................................................#........................................................................................................................
.......................................................................................................................#........................................................................................................................
.......................................................................................................................#........................................................................................................................