.........................#####...................................................................................................................#####..........................................................................................
.......................................................................................................................#.......................................................................................................................#
.................................................................................................................#.....#.................................................................................................................#.....#
.......................................................................................................................#.......................................................................................................................#
................................#######..............................................................................#.#.............................*..#######..............................................................................#.#
...............................#.......................................................................................#...............................#.......................................................................................#
..............................#.#...................................................................................#..#..............................#.#...................................................................................#..#
.............................#...#.................................................................................#...#.............................#...#.................................................................................#...#
............................#...###....*.....*....................................................................#....#............................#...###....#.....#....................................................................#....#
...........................#....................................................................................#......#...........................#....................................................................................#......#
...................|.....##.............#####.................................................................#........#.........................##.............#####.............................#........................|..........#........#
.........................#...................................................................###...#...#.....#.......#.#.........................#................................................#..................###.......#.....#.......#.#
##################.##.#######...#####.###############################...############..#####################################################.##.######.#################.######################.#############..##################################
.....................................###########.......................................................................#........................................................................................................................
.......................................................................................................................#........................................................................................................................
.......................................................................................................................#........................................................................................................................
.......................................................................................................................#........................................................................................................................
.......................................................................................................................#........................................................................................................................
.......................................................................................................................#........................................................................................................................
.......................................................................................................................#........................................................................................................................
.......................................................................................................................#........................................................................................................................
.......................................................................................................................#........................................................................................................................
.......................................................................................................................#........................................................................................................................
.......................................................................................................................#........................................................................................................................